111111111111111111111
1000E0000000000C00001
111111010010000010101
101111000010101000001
1P0000001C10C00000001
111111111111111111111