1111111111111111111111111111111111
1000E00000000000C00M00C00000000001
1011110100100000101001000000010101
1011110010101010001001000000010101
100000000C00C00000P000001C10000001
101111010010000010100100000001M101
101M11001010101000100100M000010101
1011110100100000101001000000010101
10100000101010100010010M0000010101
10111101001000001010010000M0010101
1000M0001010101000100100000001C101
1111111111111111111111111111111111