1111111111111111111111111111111111
1000E00000000000C00M00C00000000001
1011110100100000101001000000010101
1011110010101010001001000000010101
100000000C00C00000P000001C00000001
101000010010111101111010001001M101
101M00010010100001000001M100010101
1010000100101110011100001000010101
10100001001010000100000M1000010101
10111101111010000100000010M0010101
1000M0000000000000000000000001C101
1111111111111111111111111111111111