111111111111111111
1CME000C0M00MMC001
10000100C000C00011
1PC0110000MMMMC001
111111111111111111