111111111111111111
1CME000CM000M0C001
10000100C000C00011
1PC0110000M000C001
111111111111111111